90
0
13
5
3
2
1
+P+B+P+C+
PBVBVBPBV
+P+C+P+V+
BBVBBBVBP
BB+P+P+V+
