35
0
84
10
9
3
1
+P+P+B+P+V+P+P+B+B+
PBBBPBBBPBPBPBBBPBP
+P+P+P+P+B+P+P+P+P+
BBBBCBBBPBPBBBPBBBB
+P+P+V+B+V+P+V+P+B+
PBBBBBBBVBBBPBBBPBB
+P+P+P+B+P+B+V+P+P+
VBBBBBBBPBPBBBPBBBV
+P+B+P+B+B+P+V+P+P+
PBPBBBPBBBPBPBBBPBP
+P+V+P+B+B+P+P+P+B+
PBBBBBPBPBBBBBBBBBC
+P+B+B+P+P+P+P+V+P+
VBBBPBPBBBPBBBPBBBP
+P+P+P+P+P+B+P+B+P+
PBPBBBBBVBBBPBBBPBP
+B+B+P+P+P+B+B+P+B+
